111111111111111111111111111111111111111111111111111111111111111111111111111111111111111111111111111111
111111111111111111111111111111111111111111111111111111111111111111111111111111111111111111111111111111
111111111111111111111111111111111111111111111111111111111111111111111111111111111111111111111111111111
111111111111111111111111111111111111111111111111111111111111111111111111111111111111111111111111111111
111111111111111111111111111111111111111111111111111111111111111111111111111111111111111111111111111111
111111111111111111111111111111111111111111111111111111111111111111111111111111111111111111111111111111
1E0000000000000C00000C000000000001100000000000000C00000C000000000001100000000000000C00000C000000000001
101001010010000010100100000001010110100101001000001010010000000101011010010100100000101001000000010101
101001001010101000100100000001010110100100101010100010010000000101011010010010101010001001000000010101
1P0000000C00C0000000000000000000C1100000000C00C0000000000000000000C1100000000C00C0000000000000000000C1
111111111111111111111111111111111111111111111111111111111111111111111111111111111111111111111111111111
111111111111111111111111111111111111111111111111111111111111111111111111111111111111111111111111111111
111111111111111111111111111111111111111111111111111111111111111111111111111111111111111111111111111111